{
  "map": [
    [0,0,0,0,0,0,0,0,0,0,0,0,0,0,0,0,0,0],
    [0,0,0,0,0,0,0,0,0,0,0,0,0,0,0,0,0,0],
    [0,0,1,1,1,1,0,0,0,0,0,0,0,0,0,0,0,0],
    [0,0,0,0,0,1,0,0,0,1,1,1,1,0,0,0,0,0],
    [0,0,0,0,0,1,0,0,0,0,0,0,1,0,0,0,0,0],
    [0,0,0,1,1,1,0,0,1,0,0,1,1,0,0,0,0,0],
    [0,0,0,0,0,0,0,0,1,0,0,0,0,0,0,0,0,0],
    [0,0,0,0,0,0,0,0,1,0,0,0,0,0,0,0,0,0],
    [0,0,0,0,0,0,0,0,1,0,0,1,1,1,0,0,0,0],
    [0,0,1,0,0,0,1,0,0,0,0,0,0,1,0,0,0,0],
    [0,0,1,1,1,1,1,0,0,0,0,0,1,1,0,0,0,0],
    [0,0,0,0,0,0,0,0,0,0,0,0,0,0,0,0,0,0],
    [0,0,0,0,0,0,0,0,0,0,0,0,0,0,0,0,0,0],
    [0,0,0,0,0,0,0,0,0,0,0,0,0,0,0,0,0,0]
  ],
  "rows": 14,
  "columns": 18
}